{
  "turns": 100,
  "inventorySize": 5,
  "layout": [
    "###############p###############",
    "#                     #aaspssp#",
    "# ########### ####### ####### #",
    "#      s#ssp#     #p# #       #",
    "#   u  s###s##### #a# # ##### #",
    "#         #  a#   #s#   #sss# #",
    "# ### ### # ### ###p#######a# #",
    "# #as  s#   #   #           # #",
    "# ######### # ### ### ## ## # #",
    "#        s# # #sp #pas#   #a# #",
    "####### ### # ### ##### u ### #",
    "#         # #   #       #     #",
    "# ###   u # ### ########### ###",
    "#   #   # #  s#    mum    #   #",
    "###a### #    a#           ### #",
    "#pps#s# #    s#   #   pa# #saa#",
    "#####a# ### ### # # # ### #####",
    "#aa  s#   # #ps # # #   #     #",
    "### ##### # ### # # ### ##### #",
    "#   #     #   # # # #s# sp#   #",
    "# #s# ####### # # # #a# ### # #",
    "# #a#      s#   # #  s# #   #s#",
    "# #####u   a##### ##### # #####",
    "# #   #    s#   #       #     #",
    "# # p # ##### # ####### ####u #",
    "# # #   #     # #sss    #     #",
    "# # ##### ##### #s####### ### #",
    "#   #sasp   #   #p#   #   #   #",
    "# ######### # ##### # # ### ###",
    "#           #       #   #sa pp#",
    "###############p###############"
  ],
  "legend": {
    "p": "playlist",
    "a": "album",
    "s": "song",
    " ": "empty",
    "m": "monkey",
    "u": "user",
    "#": "wall"
  }
}
