{
  "turns": 200,
  "inventorySize": 5,
  "legend": {
    " ": "empty",
    "m": "monkey",
    "#": "wall",
    "s": "song",
    "p": "playlist",
    "a": "album",
    "u": "user",
    "1": "tunnel-1",
    "2": "tunnel-2",
    "3": "tunnel-3",
    "4": "tunnel-4",
    "-": "closed-door",
    "|": "closed-door",
    "_": "open-door",
    "t": "trap",
    "b": "banana",
    "/": "lever"
  },
  "layout": [
    "########################",
    "#####paptpspspptpap#####",
    "####b#a#a#b#a##a#a#b####",
    "####                ####",
    "######  ####-/##  ######",
    "#####b  ###/1###  b#####",
    "###u##  ########  ##u###",
    "##/-##  ###pp###  ##-/##",
    "#                      #",
    "# a#bs  #s aa s#  sb#a #",
    "# a##s  bs ss sb  s##a #",
    "#       #s    s#       #",
    "#  aa s   b  b   s aa  #",
    "# s##   ss#  #ss   ##s #",
    "#      ppp#  #ppp      #",
    "####-######  ######-####",
    "####s######  ######s####",
    "####s######  ######s####",
    "####a######  ######a####",
    "####a####bt  tb####a####",
    "####p####b    b####p####",
    "####p####      ####p####",
    "#########1 mm u#########",
    "########################"
  ]
}
