{
  "turns": 100,
  "inventorySize": 1,
  "layout": [
    "#########a#######",
    "#m    #        m#",
    "# ### # ##### # #",
    "# #s# #   #   # #",
    "# #p# ### # ### #",
    "# #ss sa# # #pa #",
    "# ####### # ### #",
    "#         #   # #",
    "##### ####### # #",
    "#aaa#  u  #p# # #",
    "###a##### #a# # #",
    "#a#s#      s# # #",
    "#a#s# ####### # #",
    "#p#s#sps#     # #",
    "#a# ##### ##### #",
    "#ss       #sssss#",
    "######### #######"
  ],
  "legend": {
    "p": "playlist",
    "a": "album",
    "s": "song",
    " ": "empty",
    "m": "monkey",
    "u": "user",
    "#": "wall"
  }
}
