###############################
#   #             #        saP#
# # # ########### ### # #######
# # #     #a#   #     # #     #
s # ##### #s# # ### ##### ### #
# #     # #   #   # #       # #
# ##### # # ### # # # ##P#### #
# #Uas#   # #   #U# #   #     #
# # ss##### # # ### ### # ### #
a #         # # #   #   # #U# #
# ######### # ### ### ### # # #
#         # #     #   # # #   #
# ####### #### #### ### # ##P##
#   #s  # #       # #   #     #
### ##a #    MUM  s # ####### #
s   #   # #       # #       #U#
# ### # # ##### ### ##### # ###
#   # # #   #     #     # #   #
### # # ######### ##### # ### P
#U#   #   #     #     #   # # #
# ####### # # # ### # ##### # #
#       # #U# #  P# # #   # # a
# ####### ### ##### # # # # # #
# #as   #   #     # #   # # # #
# #s  # ### ##### # ##### # # s
s #   #   #       # #   #   # #
# ### ### ###s### # # # ##### s
# sP# #P# #       # # #   #   #
# ### #a# # ####### # ### # #s#
#       #         #     #    U#
###############################
